1111111111111111111
10001000000CP0001C1
1000010C00001110101
11100C01100E00C0101
10110000C00110001C1
1010000C000Y0000101
1001100001001000001
1111111111111111111